GATGAGTGAAAAATCGTAATGAGTCAGCAAATCACTCTGTACGTTAATGCCTTTAACAACTTTTTTTTTCCCACAAACTA	native_high
CATCGACTTATTTTTTTTTTTTGATGAAATTTTTCAGATTTTACAAAACCGTTACCCAGTTTCACGTTTTCTGAAAAAAA	native_high
GCCTCTTATTTTTTTTTTTTTCGATTTTTGGCCCACAGGTCATATTGCAAAAACCGAATGGCCGCGTCCCCCTCACGCAC	native_high
GATGAGTGAAAAATCGTAATGAGTCAGCAAATCACTGTGTACGTTAATGCCCTTAACAACTTTTTTTTTCCCACAAACTA	native_high
AGAGCGACGCAAACAGCGCGCAGACTCTACGGGTAATAGACTCACATCCACGTGACCAGTTTCCAATCGAACTTTTTCAC	native_high
GCTGAGTGAAAAATCGTAATGAGTCAGCAAATCACTGTGTACGTTAATGCCTTTAACAACTTTTTTTTTCCCACAAACTA	native_high
GAATGAAAAAAGAAAAGAGAAGACCCCCACGTGCCCTAAAAATAAAGTTAGGGCATCTATAAATTAACTAGGATATATAT	native_high
CGGGTAATGATAATATTGAGCTTGCAAGTTTTTTGAACTCGGATAGCAGCATTATCCATGACATGACACGGATCTACCGA	native_high
AGAGCGACGCAAACAGCGCGCAGACTATACGGGTAATAGACTCACATCCACGTGACCAGTTTCCAATCGAACTTTTTCAC	native_high
GATGAGTGAAAAATCGTAATGAGTCAGCAAATCACTTTGTACGTTAATGCCTTTAACAACTTTTTTTTTCCCACAAACTA	native_high
CGGGTAATGATAATATTGAGCTTGCGAGTTTTTTGAACTCGGATAGCAGCATTATCCATGACATGACACGGATCTACCGA	native_high
TTGTTCACCTTGAGTGATCCTGAAAAAAAAAAATGATGGCCGCGTTTCGAAGAAAATGAAGAAAAAATAAAGCAAACCTC	native_high
GATGAATGAAAAATCGTAATGAGTCAGCAAATCACTGTGTACGTTAATGCCTTTAACAACTTTTTTTTTCCCACAAACTA	native_high
CGAGCGACGCAAACAGCGCGCAGACTCTACGGGTAATAGACTCACATCCACGTGACCAGTTTCCAATCGAACTTTTTCAC	native_high
GGCTGTTTTTCGATAGAGTGAGAGGTGTGGGTTCTGCGGCAGAATGGATACGGGCCGTGGCTCACTGTTTACGGGAGTTT	native_high
GGACATGCATAAAGTAACATCCCAACATCTCCAAACACCCATACATATTTATATTATCGACGAGGGAATTTTTTTCTTCC	native_high
AGTGAACATTAAGCGCTAACTGTAACATAATTTACCCGGACAGTGGATGTATTCTCTATTACCCGCGTTGAAAAATGAGA	native_high
GATGAGTGAAAAATCGTAATGAGTCAGCAAATCACTGTGTACGTTAATGCCATTAACAACTTTTTTTTTCCCACAAACTA	native_high
GATGAGTGAAAAATCGTAATGAGTCAGCAAATCACTGTGTACGTTAATGCCTTTAACAACTTTTTTTTTCCCACAAACTA	native_high
GAATGAAAAAAGAAAAGAGAAGACCCCCACGTGCCCTAAAAATAAAGTTAGGGCATCTATAAAAAAACTAGGATATATAT	native_high
TTTTTCAGGCATCTGCTACAGCATAATGAAAAAATTTGAAAAATACAGACATTTCCGTGTAGAATGACAAAAAAGCTAGA	native_high
AGAGCGACGCACACAGCGCGCAGACTCTACGGGTAATAGACTCACATCCACGTGACCAGTTTCCAATCGAACTTTTTCAC	native_high
GATGAGTGAAAAATCGTAATGAGTCAGCAAATCACTGTGTACGTTTATGCCTTTAACAACTTTTTTTTTCCCACAAACTA	native_high
CGGGTAATGATAATATTGTGCTTGCAAGTTTTTTGAACTCGGATAGCAGCATTATCCATGACATGACACGGATCTACCGA	native_high
GATGAGTGAAAAATGGTAATGAGTCAGCAAATCACTGTGTACGTTAATGCCTTTAACAACTTTTTTTTTCCCACAAACTA	native_high
GGTTGTTTTTCGATAGAGTGAGAGGTGTGGGTTCTGCGGCAGAATGGATACGGGCCGTGGATCACTGTTTACGGGAGTTT	native_high
AGTGAACATTAAGCGCTAACTGTAACATAATTTACCCGGACAGTGGATGTAATCTCTATTACCCGCGTTGAAAAATGAAA	native_high
GAATGAAAAAAGAAAAGAGAAGAGCCCCACGTGCCCTAAAAATAAAGTTAGGGCATCTATAAAATAACTAGGATATATAT	native_high
GATGAGTGAAAAATCGAAATGAGTCAGCAAATCACTGTGTACGTTAATGCCTTTAACAACTTTTTTTTTCCCACAAACTA	native_high
AGTGAACATTAAGCGTTAACTGTAACATAATTTACCCGGACAGTGGATGTATTCTCTATTACCCGCGTTGAAAAATGAAA	native_high
CCTGCGTGCCCGCGCACCCTGGCGACTTCGCCTCGTTTTGGCGATTTTCTTAGCAAATATTCTTTCACGATCGAAGTGGT	native_high
GAATGAAAAAAGAAAAGAGAAGACCCCCACGTGCCCTAGAAATAAAGTTAGGGCATCTATAAAATAACTAGGATATATAT	native_high
TTTTTCAGGCATCTGCTACAGCATAATGAAAAAATTTGAAAAATACAGACATTTCCGTGTAGAATGACAAAATAGCTAGA	native_high
GGAAATGCATAAAGTAACATCCGAACATCTCCAAACACCCATACATATTTATATTATCGACGAGGGAATTTTTTTCTTCC	native_high
AGTGATCATTAAGCGCTAACTGTAACATAATTTACCCGGACAGTGGATGTATTCTCTATTACCCGCGTTGAAAAATGAAA	native_high
AGAGCGACGCAAACAGCGCGCAGACTCTACGGGTAATAGACTCACATCCACGTGACCAGTTTCCAATCGAAATTTTTCAC	native_high
GATGAGTGAAAAATCGTAAGGAGTCAGCAAATCACTGTGTACGTTAATGCCTTTAACAACTTTTTTTTTCCCACAAACTA	native_high
GGACATGCATAAAGTAACATCCGAACATCTCCAAACACCCATACATATTTATATTATCGACGAGGGAATTTTTTTCTTGC	native_high
AGAGCGACGCAAACAGCGCGCAGACTCTACGGGTAATAGACTCACATCCACTTGACCAGTTTCCAATCGAACTTTTTCAC	native_high
AGAGCGACGCAAACAGCGCGCAGACTCTACGGGTAATAGACTCACATCCACGGGACCAGTTTCCAATCGAACTTTTTCAC	native_high
CGGGTAATGATAATATTGAGCTTGCAAGTTTTTTGAACTCGCATAGCAGCATTATCCATGACATGACACGGATCTACCGA	native_high
TGGCGAACTGCATTTCAGACCTGCTTTTTTTTTTCTGTAACCCTTTTAAATTAGGGTTTGCAATCTTGGCATTTTTCTTT	native_high
GGACGTGCATAAAGTAACATCCGAACATCTCCAAACACCCATACATATTTATATTATCGACGAGGGAATTTTTTTCTTCC	native_high
GGCTGTTTTTCGATAGAGTGAGAGGTGTGGGTTCTGCGGCAGAATGGATACGGGCCGTGGATCACTGTTTACGGGAGTTT	native_high
GAATGAAAAAAGAAAAGAGAAGACCCCCACGTGCCCTAAAAATAAAGTTAGGTCATCTATAAAATAACTAGGATATATAT	native_high
CGTATGGCCCACATATGCGCGCACAGTGCGCGCAACCCTCTAAGAACGATAAACATAAAATAAACACATAAACAATCAAC	native_high
GAATGAAAAAAGAAAAGAGAAGACCCCCACGTGCCCTAAAAATAAAGTTAGGGCATCTATAAAATAAGTAGGATATATAT	native_high
AGAGCGACGCAAACAGCGCGCAGACTCTACGGGTAATAGACTCACATCCACGTGTCCAGTTTCCAATCGAACTTTTTCAC	native_high
GCAAATTTGACACGCTTTTTGAACATCCGTTTTTCACGATTTTTTAATGAAGGATCATGAAAGATTGCCACATAAGAGAA	native_high
GAATGAAAAAAGAAATGAGAAGACCCCCACGTGCCCTAAAAATAAAGTTAGGGCATCTATAAAATAACTAGGATATATAT	native_high
ATGATGACTGAATCTTAGAAGATACACGCTTGCATGATGGCTATGGCTAGCGGCTAAGGCGATATGATGGTGATGGTGAC	native_low
CAAAGTCAATGATGTTGTGTACATTAGAGGTACCAAATCTGGTGTCGAAAAGGCCGGTGAAATGGTTTTGAAATCCTTAA	native_low
AATGGATGAAGACGAGGATTAAGACGCTCCACAAATCAACATTGATGAATTATTGGACGAGTTAGATGAAATGACATTAG	native_low
ATGATGACTGAATCTTAGAAGAGACACGCTTGCATGATGGCTATGGCTAGAGGCTAAGGCGATATGATGGTGATGGTGAC	native_low
ATGATGACTGAATCTTAGAAGATACACGCTTGCATGATGGCTATGGCTAGAGGCTAAGGCGATATGATGGTGATGGTGAC	native_low
CTGTATAATGTAAGAACTAGTAATTGAGGATCATAGGATTGAAAGTTTTATAAACATTGTTAACGAATTTGACTTTAAAG	native_low
CAGGGAATGATCAACCAGTGACTGTAGTGGCCCTGGCCAATTACTACTACATGCAGAGAATCAATGAGCTACAGAATACA	native_low
AAAATAACATTAATAACCAAAATTTAAATGGCTGTATGTTTATTGGTTATTTGATCTGCACATTATGTAATTATTGATAA	native_low
TATTAGATAAGCTATGAAAGTCAATCCTTTTAATCGAGAATGTAAATATGTGGAATACACAATTTTCACCAAAGTACTAT	native_low
AAAAGTCGTCTTTCAAGGAATAATCCCCACCATCTTTCGAGATCCCCTGTAACTTATTGGCAACTGAAAGAATGAAAAGG	native_low
CAGGGAATGATCAACCAGTGACTGTAGTGGACCTGGCCAATTACTACTACAAGCAGAGAATCAATGAGCTACAGAATACA	native_low
CAGGGAATGATCAACCAGTGACTGCAGTGGACCTGGCCAATTACTACTACATGCAGAGAATCAATGAGCTACAGAATACA	native_low
TATTAGATAAGCTATGAAAGTCAATCCTTTTAATCGAGAATGTAATTATGTGGAATACACAATTTTAACCAAAGTACTAT	native_low
CAAACTCAATGATGTTGTGTACATTAGAGGTACCAAAGCTGGTGTCGAAAAGGCCGGTGAAATGGTTTTGAAATCCTTAA	native_low
ATGATGACTGAATCTTAGAAGATACACTCTTGCATGATGGCTATGGCTAGAGGCTAAGGCGATATGATGGTGATGGTGAC	native_low
CAGGGAATGATCAACCAGTGACTGTAGTGGACCTGGCCAATTACTAGTACATGCAGAGAATCAATGAGCTACAGAATACA	native_low
CAAAGTCAATGATGTTGTGTACATTAGAGGTACCAAAGCTGGTCTCGAAAAGGCCGGTGAAATGGTTTTGAAATCCTTAA	native_low
CAGGGAATGATCAACCAGTGACTGTAGTGGACCTGGCCAATTACTACTACATGCAGAGAATCAATTAGCTACAGAATACA	native_low
GAACTCCTATAAAGTTAAGTTGAAGAAACTAATAAGTACTATTATGGCCTGTTAAATCTGTGTTACGTATTAAATGGTGT	native_low
ATGATGATTGAATCTTAGAAGATACACGCTTGCATGATGGCTATGGCTAGAGGCTAAGGCGATATGATGGTGATGGTGAC	native_low
ATGATGACTGAATCTTAGACGATACACGCTTGCATGATGGCTATGGCTAGAGGCTAAGGCGATATGATGGTGATGGTGAC	native_low
CAAGGAATGATCAACCAGTGACTGTAGTGGACCTGGCCAATTACTACTACATGCAGAGAATCAATGAGCTACAGAATACA	native_low
TATTAGACAAGCTATGAAAGTCAATCCTTTTAATCGAGAATGTAAATATGTGGAATACACAATTTTAACCAAAGTACTAT	native_low
ATGATGACTGAATCTTAGAAGATACACGCTTGCATGATGGCTATGGCTAGAGGCTAAGGCGATATGATGCTGATGGTGAC	native_low
CAGGGAATTATCAACCAGTGACTGTAGTGGACCTGGCCAATTACTACTACATGCAGAGAATCAATGAGCTACAGAATACA	native_low
AAAATAACATTAATAACCAAAATTTAAATGGCTGTATGTTTATTGTTTATTTGATCTGCACATTATGTAATTAATGATAA	native_low
AATGGATGAAGACGAGGATGAAGACGCCCCACAAATCAACATTGATGAATTATTGGACGAGTTAGATGAAATGACATTAG	native_low
CAGGGAATGATCAACCAGTGACTGTAGTGGACCTGGACAATTACTACTACATGCAGAGAATCAATGAGCTACAGAATACA	native_low
CAGGGAATGATCAACCAGTGACTGTAGTGGACCTGGTCAATTACTACTACATGCAGAGAATCAATGAGCTACAGAATACA	native_low
CTCCTCCAGAGATTAAGCACTAAAGGCTAGATGAGACAAGCACTAATTTCAATGAATTAGCTTTGAATATGATATTTCTC	native_low
CTGATGACTGAATCTTAGAAGATACACGCTTGCATGATGGCTATGGCTAGAGGCTAAGGCGATATGATGGTGATGGTGAC	native_low
CTCCTCCAGAGATTAAGCACTAAAGGCTAGATGAGACAAGCACTAATTTCAATGAATTAGCTTTGAATATGATATTTCTT	native_low
ATGATGACTGAATCTTAGAAGATAGACGCTTGCATGATGGCTATGGCTAGAGGCTAAGGCGATATGATGGTGATGGTGAC	native_low
ATGATGACTGAATCTTAGAAGAAACACGCTTGCATGATGGCTATGGCTAGAGGCTAAGGCGATATGATGGTGATGGTGAC	native_low
CTCCTCCAGAGATTAAGCACTAAAGGCTAGAGGAGACAAGCACTAATTTCAATGAATTAGCTTTGAATATGATATTTCTT	native_low
TATTAGATAAGCTATGAAAGTCAATCCTTTTAATCGAGAATGTAAATATGTGGAATACACAATTTCAACCAAAGTACTAT	native_low
CTCCTCCAGAGATTAAGCACTAAAGGCTAGATGAGACAAGCACTAATTTCAATGAATTAGCTTTGAATATGATAATTCTT	native_low
ACGAATCTTTTAACCTACATATGAAGAGTAAGGTCATAAATAATAAATGTAGGGCTAAATGCAGTTAAGATTACTACAGT	native_low
AATTACTTAGTATTAAGATTCTGCCCCTTGCATGCATGCACAATATGTGCTTGCCAATTCATTTATGAACAAAAGATGGT	native_low
ATGATGACTGAATCTTAGAAGATACACGCTTGCATGATGGCTATGGCTAGAGGCTAAGGCGATATGATGGTGATGGTCAC	native_low
AGTTCCTAAGGAAGTGGAGGCATGACCATCAAAATTCATTTGATGGTCTGTTAGTATATGTATCTAACTGAGGGAGCTTC	native_low
CCAAAGGAGGTAGCAAGTAACAGTCGTATGTATCCCATACATTTATGTATCCCATATATTTCATTACATGGTGATGCTTT	native_low
TAATAGTCCCTGCTTCAAGGGTCAAAATTCCGTAGAGGTTTGGATGATTGATTTACAAAGACAATACCTTATCCTTTGGA	native_low
TGGTGAAGATCATGATTTATGGAAAAAGGGCTTTAAGGAAGAAGTTGAAAAGCAACTGAAGCATGATGGTATCGCAACCA	native_low
TATTAGATAAGCTATGAAAGTCAATCCTTTGAATCGAGAATGTAAATATGTGGAATACACAATTTTAACCAAAGTACTAT	native_low
ATGATGACTGAATCTTAGAAGATACACGCTTGCATGATGGCTATGGCTAGAGGCTAAGGCGATATAATGGTGATGGTGAC	native_low
CAGGGAATGATCAACCAGTGACTGTAGTGGACCTGGCCAATTACTACTACATGCAGAGAATCAATCAGCTACAGAATACA	native_low
CTCCTCCAGAGATTAAGCACTAAAGGCTAGATGAGACAAGCACTAATTTCAATGAATTAGCTCTGAATATGATATTTCTT	native_low
CTCCTCCAGCGATTAAGCACTAAAGGCTAGATGAGACAAGCACTAATTTCAATGAATTAGCTTTGAATATGATATTTCTT	native_low
CTCCTCCAGAGATTAAGCACTAAAGGCTAGATGAGACAAGCACTAACTTCAATGAATTAGCTTTGAATATGATATTTCTT	native_low
ATCATTTTCTCGATGAAAGCGTTGACCCCACATATCGTTAGTACTCTTGTACCCTATGATTGTGTAGAAACCGAACTACG	random
GTACCTCCTGTTGGTAGTCACGATAGATTATAAAAGTATGTTCCCACCCTATCGACGAGACTGGCATCCTAGGTGTTTGC	random
GGTGTTGGTACGTGCGCAGGTATGTAAGAGTGGTAAACGACGTGGTCAAATTAGGAATACGAATCTAGCCCTAAACCGCA	random
ACGCCTCAAATTCGCTCTAATCGAGTTGTCCCTGAACATGTTGAGTGGCCTTATAAGGTCCATAGTTCTCTGACCTTTCC	random
CTTGGGATTCGTCTTCCCAGGACCATAATGCGCGAGACCCATATAAAACTTATGGCCCGCCACGCCAACCGTTCTTTGGC	random
GTGATTCCCGCCCGATCATCCGAGTAGAGAATTTAATCTGTATATTCGCAATATAACAGGGAAGAGTGTTACCCAATTCT	random
ATACGGAGCTTTCGCGTGCGTTAAGCTCGGCAGTAGATGCGCACCGGTACATAAGATCATGCTACGAAAGCTAAAACTGG	random
CACCCTTCCTCTTGGTCCCGATAACACATGGCAAAAATGCAGTTTTAGCATTTTAGCGGCTTAAGCCATAGATCGTGCAA	random
CAAGAACTCCCCTCGAGATTCTATGATTTACTTGCTTCCAATGAATGCGTGTTATGGATGCATCGCCACCTCTGACCTTA	random
CGACGCGCTGTCGTGGGATGGTGGACATGAAGTCTGGCCGTCGCTGTACCGGAGCTGATCGAGCGCAACAGATCGAGTAA	random
CACAGTTAGCTTAGAGATGGAAGCTCCCAGCCTTCTCTGAGCCCCGACGTCTCCGAGGTGGGATCCTTGTGGCTCTCGGC	random
GACCTGATCAAGCTACGCGCTCTGAATCCCAGGGAGTTACGGTACGAAGCGATTAACACACGTCTGCGCTGAGCTAAGGA	random
GTAAGGCGAACCACAGACGAACCTAGCGTCGAGAGAAGCATGTAAGTATCGAGTGTTCGTGGGGATGAACCGCATGCTAC	random
GCGGCGGGTGCGGGTGACCTACACTCTTGATACAGCCGAACCGAAAGGCTTCCTCTAAAAGGACACGTGTCATTACAAGC	random
TAGTAACATTGATCTAACAACTAGAACCCCAGTGGCAAATGTTGTCGGGGATTTGTTGTGGGGCTTCTACACCCTTAACC	random
AACCCCAGAAGGTTAAGGTTGACGCCAACTATGGCCGGCGAATTCACTAATCTTGCCGATTCCCAATGCGTTGCTTCTTG	random
ATTGAAGTCGGAGCGGACCTACCGTACTAGCTACAGGTTCTCACGGTGCAGGCCCCACTAATGTGCGTATCCCTCGCACG	random
TATGTGGGCGCCTTGTATGTTGCTCTCTTCGTATAAACTGCCGTGGCATCTCGTCTAATTTTCGCAACACAGTACTCTTT	random
GACAGCGTCATCTTGCGCGACACCAGAACGTGATATGACTTTTTCACGACAGCGTAACGATTGGCGTTATTACGAACGGG	random
ATTATCTATCTTCGCTGGAACCCTCACGAGTCAGAGAGTGGAGGCGCAGTATCCTTTATGACTCGTCGTGTGCATTACTA	random
ACATCGGTACGCTTCCTTAGACGAGACTGCCTTTGTGTAACATGGTGCATAATTATAAATTCAAACACCTCTGAGACTCA	random
ACAAGCGCGTAACCCGCACAGATATGAGGTGATGCTAACTCTTCCTGTAACTGGCCCCGAGAAAGTCCTGGTAGAGTCCC	random
GTACACAGGAGAGGACCTTCATCGCTGCCAGGGCCTATATATCAGATCAGGGCGATTATGCTGTAATTGTCTACTGTAAA	random
ATAAGTAAGAAGAAGAGATTATTTGTCGCTTCATGCCTCCGAACACAAGCGTATCCCTTCCTCACAGTATTGCAAAGCTT	random
ATGAAAAGTCCAGCCTATTAGTCAGGGCTTCCGGTATTTTACTCACAATAGCTGCGTCCAGGCGCCACGTATCAACGCCC	random
CCGAGCAAATGGGCGTTGTGTAACACATCTTCAATGGCTCCAATGACGACAAACCACATGCAATAGCTAAATCGGAACAG	random
CTTCAGCCAGGTTCGAACCGATTTGGCATAGATATGCTCTCGATTTGTGCACAACTTCGAAAAATGAGCGTGGCAGTCGG	random
CTTTGGTATCGCCAATAGGGGGTGTCCAGCTTTATATAACCTCAAGGACATGGCAGCGCGTGACCGAGGGTCATTGGGCG	random
TCTCCCTCTATTCCGAAGTTCACGACAACCAGTAGACGGATATGTCTTGTGCCAAACTGCTAGAGTCACTTTCCGCCTGC	random
CTCTGTTGATCTGCGTGGATTTTCGTCTGTCCGTCATACCGGTCCCCACGTTTACTGACCCCAGCAAGAATTGTAAGAGT	random
TCTCCCACTGTGTGTGCGCTGGTCCAAAGGGTATAAGCACTGAGTCGGACTAGGCTTGTACGTTATACGATTCAGTATGA	random
TGAACGACATCATTTCTGAGTTGCTTGTTCCCCCTATTAGACTCAGGTACCGTACGTGTAGCTGTGGACGATTGCTGTAG	random
GGAGGATACATGGACACACCGCGAAAAAGACTGCTTGCTTGATGGCGGATCGCTGGCATTTGGGCTTTAGTTGGTCCCCA	random
CTTTCGTCAATGACCATTACGCGGATGCTTCATGCGCCTCTCTTATTTAGGATTCGTTGTATTGACGCCACATAGCAGAC	random
CGGGGGCTGTGGGCTCAGGTCCCGTAACTCCCAACTACAGGACATCCCCTAAGCGTAACATTCGCTAAATGCGACTTGCA	random
GTCCTAATTAGGCCGCGCGCCGAGGTACAAATTCGACCTGGTATCTGACCGTCTCGCCACGCGTGTCGAGTTAGCGGGAA	random
AAACGGCCCCAGCTCGTCAATATCGTCTGAATGCCCTATTTCGTCTTCGGATACTCACCGTTTCGATCGGTGGCAGAGGG	random
TTTAATACACTCTTTAGGCGTGCTATTCATATTCTTTGACCCTAGGCAGCGGACGTTGAAGAATCCGGGTTATCTGCACT	random
TAGAAAATGCGGAGACACGATCGCATCCCGTTTCCCCAAGCGTCACTGCATTGCACAGTGTCTAGTTCCCACTACTATCC	random
AGTTGGTAGCAGCCTAGCTGCTCTTAGTCGGGATTTTCTGTTTTAGAGTTGGAACCACAAACGTCTTGCTGGACTGTCAT	random
AGATCTTAATAACCGTATGGCAATCCCAGGAGTAACATCCGCTTGATTGGGAACTACAGCAATATGCCCACTCAATTAAG	random
GCGAGAGTACCGTACAGAAGCTTTGAGGATGTCCTGATTGTTGTTTCCAAAGGGTGAAAGGACAGGATCCGGGAGGGCCT	random
TGCCCCTACCCCAAGTCCGAGATGGCGAAGAGTCTTCCCGAGAGAATGCGCGTACAAATGATTTGCATCCTGCGGCCCGG	random
CTTGTCGTGTTATACAGCACTCTGTTTAGCTCCTAGTTGAGTGCCCACGAGAGTATTTTTTGCAGGGGCCAAGATGAATG	random
CGCACGACCGAACCCTACCATATGAAGAGTAGCTTCCGCAGTAATATTTTGACGCGATCGAAGTGGGTCGACAAGCGAGT	random
TGGGGGTCGCGCTACTCTATGGCGGAGGCGGTTCCCGGGGGGTCCGATCTGTCTTATCCCCGAGCTCCAATGCATCGGAG	random
TACATTGCTGCCTCCGACGGGTTATGGAGTGAAACTACTCTTTATCGGTATCGCCGACGACCCCTACGTGGAGTCCGAAC	random
CGAGCCGACCACAACGCCCTCGGGATTGTACGTGGGGCGTTAATGTAGTCTATGTATGTACTTAATAAGTTCCAATCTTT	random
CTCCATCAACGACAGTCTAGGACCAGTGGGATGACCGGTGCAATATGATTGCAGACATATCTGTTGTTGTTAATGGAGGA	random
CAGTGTTTCCACTGGTGGCTGGGTTAAGCCTTAATCAAGCGAAAATCCCCGGGATCTCCGAATAGCTGCATTCATAACGA	random
ATCATTTTCTCGCGCACAGCGTTTTGCCCACGTATCGTTAGTACTCTTTTACCCTATGATTGTGTAGAAACCGAACTACG	evolution
GTACCTCCTGTTGGTAGTCGCGAACGACGAGAAAATTTTTTTCCCACCCTATCGACGAGACTGGCATCCTAGGTGTTTGC	evolution
GGTGTTGGTACGCGCGCAGACATGTATGAGTTGTTAACGACGCGGGCAACTTAGGAATACGAATCTAGCCCTAAACCGCA	evolution
ACGCCTAAAATTCGCGCGAATCGCGTTTTCCGCGAACATGTTCCGTGGCCTTATAAGGTCCATAGTTCTCTGACCTTTCC	evolution
CTTGGGATTCGTGTTCCGAGGACCTTTTTGCGCGCGACCCATATTAAACTTATCGCCCGCCACGCGAACCGTTCTTTGGC	evolution
GTGATTCCCGCGCGAACATCCGCGCAGAGAATTTTTTCTCTATTTTCGCGATATAACAGGGAAGAGTGTTACCCAATTCT	evolution
ATACGGAGCTTTCGCGCGCGCGAAGCTCGGCATTTTTTCCGCACCGGTACGTAAGATCATGCTACGAAAGCTAAAACTGG	evolution
CACCCTTCCTCTTGGTCGCGCGAACTCCGGGAAAAAATGCAGTTTTAGCATTTTCGCGGGTTAAGCCATAGATCGTGCAA	evolution
CAAGAACTTCGCGCGCGATCCTATGATTTTCTTGCTTCCAATGTACGCGTGTTACGGATGCATCGCCACCTCTGACCTTA	evolution
CGACGCGTTCTCGTGCGGTGGTGGACACGAAGTCTGCCCGTCGCGGGACGGGAGCTGATCGAGCGCAACAGATCGAGTAA	evolution
CACAGTTAGCTTAGAGATCGGAGCGCGCAGCCTTTTCTGACCCGCGACGCGTCCGAGGTGGGATCCTTGTGGCTCTCGGC	evolution
GACCTGATCAAGATACGCGCGCGGAGTCCGCGGGCGTTACGCCACGAAGCGATTAACACACGTCTGCGCTGAGCTAAGGA	evolution
GTAAGGCGAACCACAGAAGACCCGCGCGCCGCGCGAAGCATGTAACTATCGAGCGTTCGTGGGGATGAACCGCATGCTAC	evolution
GCGGCGGGCGCGCGCGGCCTACTTTTTTGATACCGCCGAACCGAAAGTCTTCCTCTAAAAGGACACGTGTCATTACAAGC	evolution
TAGTAACATTGATCTAAAAACTCGGACCCCCGCGGGAAATATTTTCGGGCATTTGTTGTGGGGCTTCTACACCCTTAACC	evolution
AACCCCAGAAGGTTAAGGTGTACGCCGACTTTGGCCGCGGAATTCACTAATCTTCCCGATTCGCGATGCGTTGCTTCTTG	evolution
ATTGAAATCGGAGCGGACATACCGTACTAGCTATTTTTTCTCACGTGGCACGCCCCACTAATGTGCGTATCCCTCGCACG	evolution
TATGTGGGCGCCTTGTATGTTTTTTTTTTCGTACGAACTGCCGTGCCATCTCGCGTAATTTTCGCAACACAGTACTCTTT	evolution
GACAGCGTAAACTCGCGCGCCGCCCGCACGTGATATTATTTTTTCACGACAGCGTAACGATTGGCGTTATTACGAACGGG	evolution
ATTATCTATATTCGCGGGCACCCTCACGCGTCAGAGAGTGGAGGCGCAGTATCCTTTCGCGCGCGTCGTGTGCATTACTA	evolution
ACATCGGTACGCTTCCTCAGACGCGACTGCCTTTTTTTAACACCGCGCATCGTTATAAATTCAAACACCTCTGAGACTCA	evolution
ACAAGCGGGAAACGCGCACAGATCTGAGGTGATGCTATTTTTTCCCGTAACGGGCCCCGAGAAAGTCCTGGTAGAGTCCC	evolution
GTACACAGGAGAGGACCTTCTTCGCGCCCAGGGCTTTTTTACCCGAACAGGGCGATTATGCTGTAATTGTCTACTGTAAA	evolution
ATAAGTAAAAAGAAGAGATTATTTTTTTTCCCACGCCTCCGAACACCAGCGTATCCCTTCCTCACAGTATTGCAAAGCTT	evolution
ATGAAAAGTCCCGCGCATTTGTCCGGCCTTCCGGTATTTTTCTCACAATAGCCGCGTCCGGGCGCCACGTATCAACGCCC	evolution
CCGAGCAAATGGGCATTGTGTCACACATCGTCAATTTTTCCAACGACGGGAAACCACATGCAATAGCTAAATCGGAACAG	evolution
CTTCAGCCAGGTTCGAACCGATTTCGCAAACTTATTTTCTCGCTTCGTACACAACTTCGAAAAATGAGCGTGGCAGTCGG	evolution
CTTTGGTTTCGCGCACAGGGGGTGTCCAGCTTTATTTATCCGCAACGACATCGCAGCGCGTGACCGAGGGTCATTGGGCG	evolution
TCTCCCTCTATTCCGAAGTTCGCGGAAACCGCGGGACGGATATGTCCCGTGCCAAACTGCTAGAGTCACTTTCCGCCTGC	evolution
CTCTGTTGATCTGCGTAGATTTTCGTCCGCGGGTCGTACCGGTCCCCACCTTTAACGACCCCAGCAAGAATTGTAAGAGT	evolution
TCTCCCACTGTGCGTGCGCGGGCCCAAAGGGTATTATCCCCGCGTCGGACCAGGCTTGTACGTTATACGATTCAGTATGA	evolution
TGAACGACATAATTCGTGACTTGTTTTTTCCCGCGATTAGACTCAGGTCCCGTACGTGTAGCTGTGGACGATTGCTGTAG	evolution
GGAGGATACACGCGCACACCGCGAAAAAGACTGATTTTTTGCCCGCGGATCGCTGGCATTTGGGCTTTAGTTGGTCCCCA	evolution
CTTTCGTCAATGACAATTGCGCAAATTTTTCACGCGCCTCTCTTCTTTCGGATTCGTTGTATTGACGCCACATAGCAGAC	evolution
CGGGGGCTGTGCGCTCAGGGCGCGTATTTTCCAACTACGGGACATCCCCGTAGCGTAACATTCGCTAAATGCGACTTGCA	evolution
GTCCTAATTAGGGCGCGCGCCGACGTATTTTTTCGACCTCGGATCGGACCGTCTCGCCACGCGTGTCGAGTTAGCGGGAA	evolution
AAACGGCCCCAGCTCGTCTATTTCGTCCGCGCGCGCTATTTCCTCTTCGGATACTCACCGTTTCGATCGGTGGCAGAGGG	evolution
TTTAATACACTCCTCGGGCGTGCGATTCATATTTTTTCACCCGCGGCCGCGGACGTTGAAGAATCCGGGTTATCTGCACT	evolution
TAGAAAATGCGGAGACACGCGCGCATTTCGTTTCCCCACGCGTCACCGCATCGCGCAGCGTCTAGTTCCCACTACTATCC	evolution
AGTTGGTAGCAGCCTATTTGCTCTCCGCCGGGATTTTCTTTTTTCGCGTCGGAACCACAAACGTCTTGCTGGACTGTCAT	evolution
AGATCTTAATACCCGTGCGCCAATCCCAGGAGTAATATCCGCGCGCGTGGGAACTACAGCAATATGCCCACTCAATTAAG	evolution
GCGAGAGTACCGTGCAGACGCTTTGAGGATGTTCTGTTTTTTTTCCACAAAGGGTGAAAGGACAGGATCCGGGAGGGCCT	evolution
TGCCCCTACCCGAAGTCCGCGAAGGCGAAGAGTTTTCCCGCGCGCGCGCGCGTACAAATGATTTGCATCCTGCGGCCCGG	evolution
CTTGTCGTGTTATACAGCACTTTTTTTCGCGCGCGGTTGAGTCCCCACGCGAGTATTTTTTGCAGGGGCCAAGATGAATG	evolution
CGCACGACCGAAGCCTAAAATACGCAGATTTTCTTCCGCAGTAATATTTTGTCGCGATCGAAGTGGGTCGACAAGCGAGT	evolution
TGGGGGTCGCGCTATTCTCGGGCGGCCGCGGTTCGCGGGGGGTCCGATCTGTCCTCTCCCCGCGCTCCAATGCATCGGAG	evolution
TACATTGCTGCCTCGGGCGGGTTATGGAGTGAAATTTCTCTTTTCACGTATCGCGGACGACCCCTACGTGGAGTCCGAAC	evolution
CGAGCCGACTAAAACGCCCGCGGGCTTGTCCGCGCGGCGTTAATGTAGTCTACGTACGTACTTAATAAGTTCCAATCTTT	evolution
CTCCATCAACGACAGTCTCGGGCCCGTGGGATCACCGCGGCAATATGATTCCGGACAGATCTGTTGTTGTTAATGGAGGA	evolution
CAGTGTTTACACTGCGGGCCGGGTTAAGCTTTTTTCACGCGCAAATCCCCGGGATCTCCGAATAGCTGCATTCATAACGA	evolution
AGTAAATACTCGCGCAGCGCGGTGTCCCCGCGTTTCGTTAGCACTCTTTTACCCTCGGCGCGCGTGGAAACCGAACTACG	gradient
GTACATACCGTGCGCGGTCGCGAACGATCATAAAATTATTTTCCCACCCTATCGACGCGAGACGCGTCCTAGGTGTTTGC	gradient
GGTACTGGCACGCGCGCAGACATGTTTATTTTTTCAACGACGCGGTCATCTTAGGAACACGTGTCTAGCCCTAAACCGCA	gradient
ACGCGAAACATTCGCGCGCACCGTTTTTTCCCCGAACATGTTTCGTGTCCTTATACGGGCGCTCGTGCTCTGACCTTTCC	gradient
CGAGACATTCGTGCTCCGACGTTCTTTTTGCGCGAGACCAATATTAATCTTCTGTCCCGCCGCGCGTACCGTTCTTTGGC	gradient
GTTATTCCCGCGCGGACATCCGCGGAGAAAAATTTTTTTGTATTTTCACAATAAAACCGGGACGCGTGTTACCCAATTCT	gradient
ACGCGAAGTATTCGCGCGCGCGCAGCGCGGGATTAGATTCGCACCGGTACGCGAGAACGGTCTACGAAAGCTAAAACTGG	gradient
CGGCAAAACTCGCGGGCGCGCAAACTCTTGGCAAATCCGCGGTTTCAGCATTTTACCGGCGCGCGCGTTAGATCGTGCAA	gradient
GGAGAACGCCGCTCGCGCTTATTTTTTTTCCTCGCTTCCCATGATCGCGTGTCACGCGTGCATCGCGACCTCTGACCTTA	gradient
GGACGCGTTCGCGCGCGGCGCGGGGCGAAAATTTTCGCCGTCCCGGTACCGGAGCGGGTCGCGCGTAACAGATCGAGTAA	gradient
CGCGGGTCGCGTAGAGCGCGGGGCGCCCGACTTTTTCTTAGCCCCGACGTCCCCGACGCGCGCGCGTTGTGGCTCTCGGC	gradient
GACCGGGTAAACTCGCGCGCGCCGAGTCCCACGGGGTTACGCCACGTCGCGAGCAACGCGCGTGTGCGCTGAGCTAAGGA	gradient
GTAAGGGGAAAAACACGCGGACCGCGCGCCGCGCGAAGCATTTAAGCATCGAGCGTTCGTGGGGATGAACCGCATGCTAC	gradient
GCGAGGCGTGCGGGCCGCGTGCTCTTTTGATACCGCCGAACCTTAACGCTTCCTCGAAAAGGTCACGTGTCATTACAAGC	gradient
GGAAAAAATTTGTCTAACGCGTAGTTCCCCAGCGGCAAATTTTTTCGGGCATTTGCCGCGGGGCGTCTACACCCTTAACC	gradient
AAGGGCGGGGGGGAAATGCGGGCGCCGACTTTGGCCGGCGTATTCACCTATCTTGCCGAGCCGCGAGGCGTTGCTTCTTG	gradient
GGTAAAATCGGCGCGCGCGGCCCGCCCTAGCTATTTTTTCTCACGTGTCACGCCCCACTTACGCGCGTATCCCTCGCACG	gradient
TATGCGCGCGCCCCGCGTGTTTCTTTCTTCGCAAAAACTGCCGCGCCGTCTCGCGGAATGTTCGCAACACAGTACTCTTT	gradient
GACGGGGTAAACTTGCGCGCCGCCCGCACTTGATTTTTTTTTTTCACGTCAGCGGAACGAGTGTCGTTATTACGAACGGG	gradient
ATTGTATAAATTCGCGGGCACCCGCGCGCGTCAGAGCGCGGCGGCGCCGTATCCGTTCCGACGCGTGGTGTGCATTACTA	gradient
ACAGGGGTACGTTTACTCTGGCGCGCCCGCCTTTTTGTAACACGGCGCGTATCTATCCATTCAAACACCTCTGAGACTCA	gradient
ACGAGCGGAAAACGCGCGCAGACGGGCGCCGTTGCCAACTCTTCCCGTAACGCGCCCCGGGCAAGTGCTGGTAGAGTCCC	gradient
GTAAAAAGTCGCGGGCTTTTTTCGCCGCCCGGGCGTATTTATCAGATCCGGGCGCGTGTGCTGTAATTGTCTACTGTAAA	gradient
ACGGGAAAAGCGGGGCGAATTTTTTTCGCTTCACGCCTCCGAACCCGAGCGTATTCCTTCCTCACGGTATTGCAAAGCTT	gradient
AGAAAAAGTCCCGCGCAGAATTCCGGGCATCGGTTTTTTTTCTCACAACAGCCGCGTCCGGGCGCGCGGTATCAACGCCC	gradient
CCGGGTAAACGCGCGTTGTGGGAAATTTCTTCATTTGCTCCAATAACGACGAACCGCGTGCAATAGCTAAATCGGAACAG	gradient
GTAAAGACCGGCGCGCGCCGAGTTGGCAAAAATATTTTCTCGCTTTACGCACATCCTCGAAAAACGGGCGTGGCAGTCGG	gradient
CTCGGTTTTCGCGCACAGCGGGTGTCCCGCGTTTTTTAACCGCAAGGACCCGCCCGCGCGTGGCGTAGGGTCATTGGGCG	gradient
GCTCCATTTATTCCGAAGTTCTCGGGAACCACGACACGGATATGTCTCGTGCCAACCGGCGCGCGTGACTTTCCGCCTGC	gradient
CTCTGTTCACGCGCGCGGGCTTTCGTTTTTTCGCCATACCGGGTCCCACGTTTACCGACCCGAGCAAGAATTGTAAGAGT	gradient
GGTAAAACTGTGCGCGCGCGGGCCCGCCGGGTTTACGCACGGAGCCGCACCCGGCGCGTGCGTGATACGATTCAGTATGA	gradient
TGAGGGGGAAAAATTCCGGGTCTCTTTTTCCCCCGTTTATTCTCAGGTACCGTCCGCGTGGCGCGTGACGATTGCTGTAG	gradient
GGAAAATAAGTGCGCAGACCGCGCGGTTAACTTCTTTCTTGACCGCGCATCGCTGGCAATTGTGCTTTAGTTGGTCCCCA	gradient
CTCGGGTAAAAGTCGCGCGCGCGGATTTTTCCCGCGCGTCTCTAATTTAGGATTCGTCGCACGGGCGCCACATAGCAGAC	gradient
CGGGGGTTGTGCGCGCAGACGGGGTATTTCCCAACGACGGGACATCCCCGCCGCGTAACAATCGCGAAATGCGACTTGCA	gradient
GTAAAAAATAGGGCGCGCGCCGGGGGACAATTTCGCCCCGGGAACGGACCTTCTCGCCGCGCGTGGCGAGTTAGCGGGAA	gradient
AAGCGCGCCCCGCGCGCGAATTTCGTCCGAACGCGTTTTTTCGCCCTCGGACACGCACCGTCCCGTGCGGTGGCAGAGGG	gradient
GGTAAAACTCTCGCGCGGCGCGCGCTTCTTATTTTTTGACCCCCGGCCGCGGGCGTTCAACATTCCGGGTTATCTGCACT	gradient
TGGAAAACGCGCGGACGCGGGCGCGTCGCGTTTCCCCACGCGTCTCTGCATCGCACCGTGTCGCGTGCCCACTACTATCC	gradient
AGTTGGGGGGCGCGTGCGTGTTCTCACGCGGGATTTTTTTTTTTCGCGTCGGAACCAGACACGCGATGCTGGACTGTCAT	gradient
AGAGCAAAAAACTCGCGCGGCGCGCCCACGAATTATTTCCGCGTGACCGGGAACTACAGCCACGTGCGCACTCAATTAAG	gradient
GGGAGAGACGCGCGCAGACGCGCTGAGGATGTCCTGTTTTTTTTTACCGAAGCGCGCAACGACACGATCCGGGAGGGCCT	gradient
TCCCCAGACGCGAAGTTCGCGAGCGCGAAATTTTTTCCCGAGCGCACGCGCGCACGTGAGAGTTGCATCCTGCGGCCCGG	gradient
CTGCGCGTGTTGTCCCGCGCGCTTTTTCGCTCCTATTTTTATGCCCACGCGCGTAACGCTTGCATGGGCCAAGATGAATG	gradient
CGCGCGGGCGCACGCGGACACGCGCAGATTTTCTTCCGCAGCAATATCTTTCCGCGAGCGGCGCGTGTCGACAAGCGAGT	gradient
TGGGGGTCGGGTAATTCTCGGGCGGCCGCGGTTCCCGGGGGATCCGATCTCTCTTAGCCCCGCGCGCGAATGCATCGGAG	gradient
TGCATTGCTGCGCCCGCCGCGTTTTTGCGCGAAACTTTTCTTTATCGGTATCGCCCCCGACGCGTGCGTGGAGTCCGAAC	gradient
CGCGCCGCGCACTTCGCGCGCGGCTTTTTTCGCGCGGCGGTAATGCAATCTACGTACGTACGTACTAAGTTCCAATCTTT	gradient
CGGCAGGAGGGAAATTCTCGGGCGAGTGCGCCGACCGGGGCAATATCATTTCATACATATCGGGGGTTGTTAATGGAGGA	gradient
CTCTGTTTACGCGCGGGGCCGCGTTTTGTTTTTTTCACGCGAAATTCCCCGGGCTCTTCGCGTAGCGGCATTCATAACGA	gradient
